111111111111111111111111111111111111111111111111111111111
111111000001110000011111111111111111110000011100000111111
111111000000100000011111111111111111110000001000000111111
111111000000000000011111111111111111110000000000000111111
111111000000001000011111111111111111110000000000000111111
111111000000000000100001000101000100000000000000000111111
111111000000100001000001000101010100000000001000000111111
111111000001110000P00001000100010100000000011100000111111
100000000011111000000000010101010000000000111110000000001

101111000001110000000001010001000100000000011100000011101
111111111111111111111111111111111111111111111111111111111