

	NO  ../PATHN
	WE	./PATHW
	EA  ../PATHE
	SO  ../PATHS

F  56,56,56
C  113,113,25444444



        11111111111111111111
        100000000011000000011
    1111000001110000000000011
    1001000000000000000000001
1111111110110N111001110000000111
10000000001100000111011111111
11110111111111011100000010001
11110111111111011101010010001
11000000110101011100000010001
11111111111111111111111111111     
1111111111111111111111111111111
10000000000000001100000010001
10000000000000001101010010001
11000001110101011111011110011
11110111 1110101 1011110100001
111111111 1111111 1111111111111111
                                
















