
	
    
    
    
    
    
    
    
    
    
    
      wall_test.xpm
	WE	wall_test.xpm
	EA  wall_test2.xpm
	SO  wall_test2.xpm

F  56,56,56
C  113,100,254

11111111111111111111
    10000010000000001
    100001111111111111111111111
    10000011000010000000010001
    1000001000010000000000001
    10000011000010000000010001
    11101111111011111111110001
    110000110000001      10001
    100000010000001     10001
    100000010000001      10001
    10000000000000111111111011111111111
    10000001000000100000000E00000000001
    1000000100000010000000000000000000111
    11000011000000100111000000000011001001
    1111111111111111111111111111111111111
